id,wifi,distance_to_bathroom,distance_to_kitchen,distance_to_advisor0,distance_to_advisor1,size,seats,cabinet
1,0,0,2,1,1,2,2,1
2,1,0,2,1,1,2,1,1
3,1,1,2,1,1,2,1,1
4,0,2,2,1,1,2,1,1
5,0,2,1,1,1,2,1,1
6,0,2,0,1,1,1,2,0
7,0,2,0,0,1,2,2,1
8,1,2,0,0,1,2,1,0
9,1,2,0,0,0,2,2,1
10,0,2,0,0,0,2,4,0
11,1,2,0,0,0,2,2,1
12,1,2,0,0,0,0,1,0
13,1,1,0,0,0,0,1,0
14,1,1,0,0,0,2,3,1